1,1,1,1,1,1,1,1,1,1,1,1,1,1,1,1,1,1,1,1,,/,0 = 道,,,,
1,0,0,0,0,1,1,0,1,0,1,0,0,0,1,0,0,0,1,1,,/,1 = 壁,,,,
1,0,1,1,0,0,1,0,1,0,0,0,1,0,1,0,1,0,1,1,,/,2 = 階段,,,,
1,0,0,1,1,0,1,0,1,1,1,0,1,0,1,0,1,0,1,1,,/,3 = 扉,,,,
1,1,0,1,1,0,0,0,0,0,0,0,1,0,0,0,1,0,1,1,,/,4 = 鍵,,,,
1,1,0,1,1,1,1,1,1,1,1,1,1,1,1,1,1,0,1,1,,/,作成する際は画面下のマップを変更してください,,,,
1,1,0,0,0,0,0,0,0,0,0,0,0,0,0,0,0,0,1,1,,,,,,,
1,1,1,1,1,1,1,1,1,1,1,1,1,1,1,1,1,1,1,1,,,,,,,
1,1,0,0,0,0,0,0,0,0,0,0,0,0,0,0,0,0,1,1,,,,,,,
1,1,0,1,1,1,1,1,1,1,1,1,1,1,1,1,1,0,1,1,,,,,,,
1,1,0,1,1,0,0,0,0,0,0,0,1,4,0,0,1,0,1,1,,,,,,,
1,2,0,1,1,0,1,0,1,1,1,0,1,0,1,0,1,0,1,1,,,,,,,
1,3,1,1,0,0,1,0,1,0,0,0,1,0,1,0,1,0,1,1,,,,,,,
1,0,0,0,0,1,1,0,1,0,1,0,0,0,1,0,0,0,1,1,,,,,,,
1,1,1,1,1,1,1,1,1,1,1,1,1,1,1,1,1,1,1,1,,,,,,,
